7 7 7 7 7 7 7 7 7 7 7 7 7 7 7 7 7 7 7 7 7 7 7 7 7 7 7 7 7 7 7 7 7 7 7 7 7 7 7 7 7 7 7 7 7 7 7 7
7 7 7 7 7 7 7 7 7 7 7 7 7 7 7 7 7 7 7 7 7 7 7 7 7 7 7 7 7 7 7 7 7 7 7 7 7 7 7 7 7 7 7 7 7 7 7 7
7 7 7 7 7 7 7 7 7 7 7 7 7 7 7 7 7 7 7 0 0 0 0 0 0 0 7 7 7 7 7 7 7 7 7 7 7 7 7 7 7 7 7 7 7 7 7 7
7 7 7 7 7 7 7 7 7 7 7 7 7 7 7 7 7 7 7 0 0 0 0 0 0 0 7 7 7 7 7 7 7 7 7 7 7 7 7 7 7 7 7 7 7 7 7 7
7 7 7 7 7 7 7 7 7 7 7 7 7 7 7 7 7 7 7 0 c 0 0 0 0 0 0 7 7 7 7 7 7 7 7 7 7 7 7 7 7 7 7 7 7 7 7 7
7 7 7 7 7 7 7 7 7 0 0 0 0 0 0 0 0 0 0 0 0 0 0 0 0 0 0 0 7 7 7 7 7 7 7 7 7 7 7 7 7 7 7 7 7 7 7 7
7 7 7 7 7 7 7 7 7 0 0 0 0 0 0 0 0 0 0 0 0 0 0 0 0 0 0 0 0 7 7 7 7 0 0 0 7 7 7 7 7 7 7 7 7 7 7 7
7 7 7 7 7 7 7 7 7 0 0 0 0 7 7 7 7 7 7 7 0 0 0 7 7 0 0 0 0 0 0 0 0 0 0 0 7 7 7 7 7 7 7 7 0 0 7 7
7 7 7 7 7 7 7 7 7 0 0 0 0 7 7 7 7 7 7 7 0 0 0 7 7 7 7 7 0 0 0 0 0 0 0 0 0 0 0 0 0 0 0 0 0 0 7 7
7 7 7 7 7 7 7 7 7 0 0 0 0 7 7 7 7 7 7 7 7 0 0 0 7 7 7 7 7 7 7 7 7 0 0 0 0 0 0 0 0 0 0 0 0 0 7 7
7 7 7 7 7 7 7 7 7 7 0 0 7 7 7 7 7 7 7 7 7 7 0 0 0 7 7 7 7 7 7 7 7 7 7 7 7 7 7 7 7 7 7 7 0 0 7 7
7 7 7 7 7 7 7 7 7 0 0 0 0 7 7 7 7 7 7 7 7 7 7 0 0 0 7 7 7 7 7 7 7 7 7 7 7 7 7 7 7 7 7 7 0 0 7 7
7 7 7 7 7 7 7 7 7 0 0 0 0 7 7 7 7 7 7 7 7 7 7 7 0 0 0 0 7 7 7 7 7 7 7 7 7 7 7 7 7 7 7 7 0 0 7 7
7 7 7 7 7 7 7 7 7 0 0 0 0 7 7 7 7 7 7 7 7 7 7 7 7 0 0 0 0 0 0 0 0 0 0 0 0 0 0 7 7 7 7 7 0 0 7 7
7 7 7 7 0 0 0 0 0 0 0 0 0 0 7 7 7 7 7 7 7 7 7 7 7 7 7 0 0 0 0 0 0 0 0 0 0 0 0 0 7 7 7 7 0 0 7 7
7 7 7 7 0 0 7 7 0 0 0 0 0 0 7 7 7 7 7 7 7 7 7 7 7 7 7 0 0 0 7 7 7 7 7 7 7 7 0 0 0 7 7 7 0 0 7 7
7 7 7 7 0 0 7 0 0 0 7 7 0 0 7 7 7 7 7 7 7 7 7 7 7 7 7 0 0 0 7 7 7 7 7 7 7 7 7 0 0 7 7 7 0 0 7 7
7 7 7 7 0 0 0 0 0 0 0 7 0 0 0 0 0 0 0 0 0 0 0 0 0 0 0 0 0 0 7 7 7 7 7 7 0 0 0 0 0 0 0 0 0 0 7 7
7 7 7 7 0 0 7 0 0 0 a 0 0 0 0 0 0 0 0 0 0 0 0 0 0 0 0 0 0 0 7 7 7 7 7 7 0 0 0 0 0 0 0 0 0 0 7 7
7 7 7 7 0 0 7 7 0 0 0 0 0 0 7 7 7 7 7 7 0 0 0 0 0 0 0 0 0 0 7 7 7 7 7 7 0 0 0 b 0 0 0 0 7 7 7 7
7 7 7 7 0 0 0 0 0 0 0 0 0 0 7 7 7 7 7 7 7 7 7 7 7 7 0 0 0 0 7 7 7 7 7 7 0 0 0 0 0 0 0 0 7 7 7 7
7 7 7 7 0 0 0 0 0 0 0 0 0 0 7 7 7 7 7 7 7 7 7 7 7 7 0 0 0 0 7 7 7 7 7 7 0 0 0 0 0 0 0 0 7 7 7 7
7 7 7 7 7 7 7 7 7 0 0 0 7 7 7 7 7 7 7 7 7 7 7 7 7 7 0 0 0 0 7 7 7 7 7 7 7 0 0 7 7 0 0 0 7 7 7 7
7 7 7 7 7 7 7 7 7 0 0 0 7 7 7 7 7 7 7 7 7 7 7 7 7 7 7 0 0 7 7 7 7 7 7 7 0 0 0 7 7 0 0 0 7 7 7 7
7 7 7 7 7 7 7 7 7 0 0 0 7 7 7 7 7 7 7 7 0 0 0 0 0 7 0 0 0 0 7 7 7 7 7 0 0 0 7 7 7 0 0 0 7 7 7 7
7 7 7 7 7 7 7 7 7 0 0 0 7 7 7 7 7 7 7 7 0 0 0 0 0 0 0 0 0 0 7 7 7 7 0 0 0 7 7 7 7 0 0 0 7 7 7 7
7 7 7 7 7 7 7 7 7 0 0 0 7 7 7 7 7 7 7 7 0 0 0 0 0 0 0 0 0 0 7 7 7 0 0 0 7 7 7 7 7 0 0 0 7 7 7 7
7 7 7 7 7 7 7 7 7 0 0 0 7 7 7 7 7 7 7 7 0 0 0 0 0 7 7 7 7 7 7 7 0 0 0 7 7 7 7 7 7 0 0 0 7 7 7 7
7 7 7 7 7 7 7 7 7 0 0 0 7 7 7 7 7 7 7 7 0 0 0 7 7 7 7 7 7 7 7 0 0 0 7 7 7 7 7 7 7 0 0 0 7 7 7 7
7 7 7 7 7 7 7 7 7 0 0 0 7 7 7 7 7 7 7 7 0 0 0 7 7 7 7 0 0 0 0 0 0 7 7 7 7 7 7 7 0 0 0 0 0 7 7 7
7 7 7 7 7 7 7 7 7 7 0 0 7 7 7 7 7 7 7 7 0 0 0 7 7 7 7 0 0 0 0 0 7 7 7 7 7 7 7 7 0 0 0 0 0 7 7 7
7 7 7 7 7 7 7 7 7 7 0 0 7 7 7 7 7 7 7 7 0 0 0 7 7 7 7 0 0 0 0 7 7 7 7 7 7 7 7 7 0 0 0 0 0 7 7 7
7 7 7 7 7 7 7 7 7 7 0 0 0 0 0 0 7 7 7 7 0 0 0 0 0 0 0 0 0 0 0 7 7 7 7 7 7 7 7 7 0 0 0 0 0 7 7 7
7 7 7 7 7 7 7 7 7 7 0 0 0 0 0 0 7 7 7 7 0 0 0 0 0 0 0 0 0 0 0 0 0 0 0 0 0 0 0 0 0 0 0 0 0 7 7 7
7 7 7 7 7 7 7 7 7 7 0 0 0 0 0 0 0 0 0 0 0 0 0 7 7 7 7 7 0 0 0 0 0 0 0 0 0 0 0 0 0 0 0 0 0 7 7 7
7 7 7 7 7 7 7 7 7 7 7 7 7 7 0 0 0 0 0 0 0 0 0 7 7 7 7 7 0 0 0 0 0 0 0 0 0 0 0 0 0 7 7 7 7 7 7 7
7 7 7 7 7 7 7 7 7 7 7 7 7 7 7 7 0 0 0 0 0 7 7 7 7 7 7 7 0 0 0 7 7 7 7 7 7 7 7 7 7 7 7 7 7 7 7 7
7 7 7 7 7 7 7 7 7 7 7 7 7 7 7 7 0 0 0 0 0 7 7 7 7 7 7 7 0 0 0 7 7 7 7 7 7 7 7 7 7 7 7 7 7 7 7 7
7 7 7 7 7 7 7 7 7 7 7 7 7 7 7 7 0 0 0 0 0 7 7 7 7 7 7 7 0 0 0 7 7 7 7 7 7 7 7 7 7 7 7 7 7 7 7 7
7 7 7 7 7 7 7 7 7 7 7 7 7 7 7 7 0 0 0 0 0 7 7 7 7 7 7 7 0 0 0 7 7 7 7 7 7 7 7 7 7 7 7 7 7 7 7 7
7 7 7 7 7 7 7 7 7 7 7 7 7 7 7 7 0 0 0 0 0 7 7 7 7 7 7 7 0 0 0 7 7 7 7 7 7 7 7 7 7 7 7 7 7 7 7 7
7 7 7 7 7 7 7 7 7 7 7 7 7 7 7 7 0 0 0 0 0 7 7 7 7 7 7 7 0 0 0 7 7 7 7 7 7 7 7 7 7 7 7 7 7 7 7 7
7 7 7 7 7 7 7 7 7 7 7 7 7 7 7 7 0 0 0 0 0 0 0 0 0 0 0 0 0 0 0 7 7 7 7 7 7 7 7 7 7 7 7 7 7 7 7 7
7 7 7 7 7 7 7 7 7 7 7 7 7 7 7 7 0 0 0 0 0 0 0 0 0 0 0 0 0 0 0 7 7 7 7 7 7 7 7 7 7 7 7 7 7 7 7 7
7 7 7 7 7 7 7 7 7 7 7 7 7 7 7 7 7 7 0 0 0 0 0 0 0 0 0 0 7 7 7 7 7 7 7 7 7 7 7 7 7 7 7 7 7 7 7 7
7 7 7 7 7 7 7 7 7 7 7 7 7 7 7 7 7 7 0 t 0 0 0 0 0 0 0 0 7 7 7 7 7 7 7 7 7 7 7 7 7 7 7 7 7 7 7 7
7 7 7 7 7 7 7 7 7 7 7 7 7 7 7 7 7 7 0 0 0 0 0 0 0 0 0 0 7 7 7 7 7 7 7 7 7 7 7 7 7 7 7 7 7 7 7 7
7 7 7 7 7 7 7 7 7 7 7 7 7 7 7 7 7 7 7 7 7 7 7 7 7 7 7 7 7 7 7 7 7 7 7 7 7 7 7 7 7 7 7 7 7 7 7 7